after      = month
assert     = delay
assume     = teenager
battery    = library
bring      = accept
brush      = interest
certain    = represent
chair      = contrast
collapse   = capacity
content    = volume
enhance    = channel
error      = analysis
explosion  = listen
fifth      = difference
frame      = coffee
frequency  = urban
gentleman  = typical
himself    = foreign
incredible = raise
instrument = singer
justify    = unlike
lawsuit    = inflation
medicine   = comfort
minute     = exact
photograph = maintain
phrase     = owner
primarily  = novel
protest    = interview
reflect    = nature
relatively = trace
result     = orange
rough      = cable
sense      = monitor
slide      = expect
someone    = diverse
surround   = finally
trust      = hearing
welcome    = strongly
withdraw   = counselor
wonder     = mostly
