adult      = catch
appearance = horror
assess     = newspaper
attempt    = adjust
audience   = campaign
billion    = sentence
capital    = cancer
chemical   = lesson
conduct    = window
contribute = complain
criteria   = scream
depth      = container
discipline = village
efficient  = clock
emotional  = elementary
examine    = handle
fantasy    = garage
fault      = believe
front      = proposed
glance     = expense
habitat    = scientific
human      = bottle
nation     = together
number     = disease
politician = accuse
remarkable = class
retirement = steel
scientist  = tourist
shape      = cigarette
sometimes  = threaten
speaker    = payment
stick      = ocean
strike     = champion
style      = adventure
tongue     = phenomenon
tragedy    = afternoon
variation  = community
which      = brain
within     = porch
yield      = absolute
