according  = routine
adopt      = forward
agent      = squeeze
blood      = admire
bunch      = trouble
campus     = nobody
candidate  = shock
center     = entrance
dependent  = virtue
detail     = supposed
dominant   = perceive
elderly    = express
emphasis   = press
fortune    = throw
freeze     = amount
glass      = politics
guess      = winner
junior     = combine
limited    = degree
loose      = inform
match      = motivation
overlook   = terror
place      = butter
plenty     = meanwhile
pride      = governor
profile    = online
psychology = detailed
recommend  = difficult
relevant   = contract
reputation = resolve
request    = under
silver     = plant
sound      = forest
stand      = watch
stone      = particular
those      = develop
track      = sleep
ultimately = change
violation  = transform
wisdom     = imagine
