actor      = original
admit      = achieve
arrange    = final
aspect     = normally
assault    = dramatic
central    = absence
color      = speech
concern    = reasonable
democratic = active
dinner     = dining
education  = perception
eight      = emotion
everyone   = health
explain    = skill
factory    = fully
language   = scope
large      = reduction
learning   = narrative
liberal    = dismiss
makeup     = familiar
mistake    = workshop
normal     = fighter
obligation = negative
portion    = onion
punishment = fifty
radio      = variable
sacred     = repeatedly
sister     = nuclear
slave      = permission
something  = girlfriend
suppose    = official
surprised  = generation
teach      = upper
theme      = child
thing      = thirty
tournament = craft
truck      = territory
truth      = quickly
whatever   = respondent
would      = apple
