brother    = confront
clinical   = soldier
couple     = heaven
crisis     = range
cultural   = depict
decade     = legacy
describe   = product
enter      = panel
golden     = mirror
grand      = totally
growth     = somewhere
identity   = associate
involve    = previous
lemon      = student
manage     = testimony
modest     = become
naked      = customer
operating  = drink
other      = ethnic
perform    = address
player     = thought
process    = elsewhere
project    = personally
prompt     = highlight
propose    = criticism
reading    = chief
reform     = heritage
research   = evolution
revenue    = chest
shortly    = release
similar    = professor
species    = property
steal      = exercise
strategic  = household
sufficient = youth
valuable   = score
veteran    = humor
vital      = publish
where      = previously
while      = vision
