abuse      = option
actual     = regard
attitude   = method
attribute  = button
author     = occasion
better     = whether
calculate  = sales
challenge  = birth
county     = ordinary
cycle      = pregnancy
demand     = fitness
diversity  = testing
during     = special
estimate   = invest
except     = settle
field      = differ
giant      = museum
impact     = terrorist
income     = confusion
indicate   = remote
literature = recruit
media      = reduce
nomination = federal
notion     = legitimate
paper      = inquiry
passenger  = including
photo      = usually
principle  = hospital
prisoner   = difficulty
procedure  = ceiling
sector     = prospect
shift      = derive
shore      = mainly
south      = shout
space      = forth
staff      = advance
string     = absorb
though     = factor
ticket     = selection
trick      = joint
