ancient    = jacket
apply      = throat
begin      = damage
borrow     = shopping
brick      = physical
burden     = depression
collection = classic
condition  = happy
consensus  = anything
country    = admission
critic     = taste
deficit    = chairman
eastern    = negotiate
effect     = musical
headline   = highly
journalist = quality
justice    = insight
killer     = decision
laugh      = substance
lifestyle  = garlic
military   = scared
music      = advanced
nurse      = pregnant
pattern    = pilot
position   = component
present    = consist
regardless = additional
romantic   = compete
scale      = along
serious    = consider
shall      = opinion
slight     = refugee
society    = rather
sorry      = slowly
speak      = blanket
tight      = vacation
tradition  = former
transfer   = enjoy
useful     = delivery
worker     = suggestion
