accurate   = receive
agenda     = pocket
amazing    = senior
apparently = breakfast
broken     = tobacco
chain      = whose
chart      = guarantee
complaint  = neither
conference = guide
contact    = detect
convince   = angle
darkness   = fiber
downtown   = solve
dream      = academic
economic   = stare
element    = boundary
finance    = entire
freedom    = civilian
hello      = private
initially  = slice
internal   = aware
moral      = objective
occupation = assist
opponent   = conflict
otherwise  = helicopter
painting   = point
philosophy = provision
portrait   = drama
possibly   = expert
properly   = teacher
review     = confident
seven      = version
shadow     = helpful
smell      = breath
social     = float
surprising = union
vulnerable = investment
weekend    = practice
western    = husband
widely     = disappear
