among      = trend
badly      = naturally
boyfriend  = until
buyer      = honey
collect    = weekly
common     = bathroom
conviction = fairly
credit     = pitch
criminal   = lover
decline    = ability
either     = hundred
expansion  = general
flesh      = somewhat
grass      = smile
grocery    = horizon
homeless   = platform
include    = stair
leadership = about
legal      = alliance
length     = divide
limitation = disorder
object     = competitor
obvious    = capable
plane      = literally
producer   = status
quiet      = awful
register   = apart
relative   = rural
remove     = pause
season     = engine
seize      = dance
single     = sample
smooth     = series
surgery    = speed
taxpayer   = potential
temporary  = remain
tired      = insist
virus      = total
voter      = anywhere
write      = wealth
