affect     = constantly
available  = article
behavior   = subsequent
blade      = football
bright     = history
carefully  = powder
cross      = technique
daughter   = terrorism
discuss    = shrug
editor     = teaching
elect      = define
employer   = current
enemy      = trade
event      = fresh
family     = count
frequently = camera
gender     = educator
genetic    = nervous
industry   = prepare
ingredient = proposal
inner      = statement
later      = local
light      = train
likely     = healthy
myself     = motion
operation  = false
perfectly  = permit
powerful   = mountain
recent     = sexual
saving     = sudden
shoulder   = asset
sight      = expand
slightly   = remaining
statistics = favorite
strengthen = silent
summit     = memory
travel     = green
tunnel     = people
waste      = domestic
witness    = barely
