account    = respect
adequate   = submit
adolescent = fighting
again      = reference
agree      = dangerous
apparent   = dominate
artist     = layer
atmosphere = glove
bridge     = episode
chase      = relief
compose    = remind
concept    = satellite
creature   = completely
danger     = explode
decrease   = university
desperate  = grain
direct     = thinking
educate    = despite
evaluate   = building
everyday   = scene
fishing    = bottom
indication = formula
invasion   = entirely
nearly     = proof
office     = marry
officer    = knock
patch      = consume
penalty    = important
reflection = moreover
solar      = handful
start      = surprise
storm      = quarter
story      = originally
success    = obviously
training   = promise
typically  = valley
unlikely   = majority
usual      = northern
violence   = heavily
welfare    = bread
