appear     = immigrant
arrive     = comment
build      = silence
carrier    = dealer
colleague  = funny
colonial   = faculty
connect    = reply
control    = therefore
corporate  = today
determine  = attention
edition    = physically
efficiency = financial
example    = earth
expression = rapidly
flame      = source
focus      = passage
framework  = bedroom
frequent   = predict
hardly     = chance
hunter     = react
install    = importance
might      = spirit
movie      = budget
produce    = habit
prominent  = cover
proper     = afford
recognize  = anymore
regarding  = evaluation
reject     = master
shooting   = aircraft
solid      = regular
survey     = overcome
theater    = labor
their      = radical
viewer     = reporter
visitor    = personnel
visual     = mouth
wedding    = fifteen
whenever   = architect
yellow     = confirm
