access     = opening
alone      = confidence
attend     = armed
broad      = existing
chocolate  = attach
church     = utility
clearly    = father
commission = pleasure
conclusion = everything
concrete   = elite
consumer   = roughly
create     = culture
destroy    = theory
first      = exposure
following  = journal
gently     = around
government = sheet
interpret  = category
leader     = never
least      = station
locate     = emerge
lucky      = exhibit
magazine   = protein
massive    = awareness
motor      = attorney
period     = technical
political  = defendant
popular    = yesterday
publicly   = resemble
quietly    = before
refer      = venture
restore    = weight
service    = acquire
shine      = chamber
stage      = planet
suddenly   = knowledge
survival   = sweet
switch     = dozen
themselves = square
variety    = charity
