above      = sauce
advantage  = victory
agreement  = through
although   = accident
bombing    = attack
civil      = alive
closer     = dimension
commercial = increased
complex    = draft
convert    = shell
cream      = matter
critical   = practical
defeat     = threat
democracy  = anyone
discovery  = climb
document   = hypothesis
embrace    = disagree
evolve     = still
flavor     = guideline
found      = sugar
imply      = session
innocent   = contain
intensity  = director
lunch      = visible
pepper     = rhythm
potato     = structure
provide    = function
record     = eventually
regime     = dress
respond    = knife
salad      = soccer
salary     = beauty
school     = instructor
secret     = generate
seriously  = beautiful
signal     = stable
stability  = basis
treat      = stake
ultimate   = thousand
wander     = minority
