benefit    = willing
black      = several
cheap      = widespread
choose     = neighbor
claim      = block
direction  = against
disaster   = offense
eliminate  = strange
equally    = remember
exist      = strip
facility   = partner
gallery    = instead
generally  = illegal
grade      = simply
ignore     = courage
illustrate = spend
indeed     = value
label      = exhibition
landscape  = given
money      = sharp
painter    = universe
partly     = protection
phone      = lawyer
please     = serve
police     = exciting
prior      = security
relax      = store
resident   = towards
retire     = fewer
sanction   = dirty
separate   = group
should     = judgment
software   = extreme
specific   = command
subject    = target
summer     = storage
support    = mystery
suspect    = barrier
tower      = across
twelve     = manner
