agency     = gradually
argue      = cabin
assistant  = gesture
beside     = unable
carbon     = shower
charge     = criticize
climate    = nearby
coverage   = drive
crash      = stock
crazy      = profit
defense    = piano
depending  = ensure
economy    = treatment
estate     = emphasize
exceed     = organic
farmer     = design
finish     = constant
guard      = defend
guilty     = writing
house      = lifetime
involved   = wealthy
largely    = struggle
license    = mount
machine    = third
manager    = cluster
margin     = impression
overall    = career
prison     = warning
proceed    = refuse
production = meter
proud      = protect
prove      = classroom
provider   = famous
revolution = solution
scandal    = occupy
shake      = deeply
specialist = beginning
tablespoon = appreciate
truly      = regulation
unusual    = principal
