absolutely = reinforce
afraid     = barrel
arise      = cloud
baseball   = ought
basically  = volunteer
battle     = cooking
beach      = victim
below      = album
brilliant  = district
character  = regulate
court      = wound
deserve    = exactly
division   = celebrate
divorce    = captain
economist  = miracle
evening    = legend
fellow     = affair
fence      = introduce
historical = everywhere
hotel      = learn
housing    = directly
journey    = action
marketing  = height
medium     = paint
missile    = computer
mission    = whisper
moment     = announce
numerous   = tennis
opposition = artistic
possess    = winter
prayer     = short
pretend    = scenario
question   = table
screen     = mental
search     = stress
since      = dispute
situation  = illness
split      = capability
supply     = therapy
wonderful  = league
