addition   = resort
almost     = enable
appeal     = certainly
attract    = advocate
behind     = between
cause      = rating
cheek      = incentive
citizen    = another
closely    = island
could      = grant
decide     = trial
economics  = origin
emergency  = throughout
employee   = escape
favor      = female
funding    = undergo
invite     = leading
latter     = message
little     = priority
material   = whole
mayor      = celebrity
measure    = recording
occur      = belong
outside    = without
pollution  = friendly
population = birthday
preserve   = growing
reader     = crime
region     = sweep
relate     = creative
resist     = study
science    = permanent
smart      = fashion
sport      = basket
suffer     = unless
suggest    = steady
talent     = chicken
tooth      = historic
troop      = obtain
unknown    = effective
