adjustment = personal
alcohol    = resource
analyst    = instance
assign     = thank
break      = aside
careful    = phase
carry      = construct
ceremony   = asleep
changing   = rapid
complete   = founder
cotton     = shoot
custom     = similarly
digital    = clothes
disability = coast
discourse  = necessary
discover   = individual
electronic = violent
essential  = telescope
expensive  = excellent
extensive  = schedule
grave      = deputy
hunting    = mortgage
infection  = natural
influence  = location
investor   = hungry
maker      = airline
notice     = policy
organize   = avoid
positive   = foundation
river      = average
safety     = religion
sequence   = spread
standard   = horse
tomato     = program
transition = treaty
translate  = capture
uniform    = successful
vehicle    = settlement
wheel      = mechanism
working    = honest
