allow      = recovery
already    = cognitive
arrest     = worried
assessment = ethics
brand      = noise
brown      = poetry
collective = shelf
curious    = college
currently  = explore
death      = second
definitely = ghost
distance   = especially
doubt      = topic
drawing    = limit
engineer   = progress
experiment = athlete
extremely  = somebody
fight      = declare
funeral    = expose
however    = racial
image      = heavy
infant     = persuade
injury     = moderate
literary   = equal
member     = easily
newly      = precisely
north      = really
pound      = activity
pretty     = check
print      = technology
resolution = woman
running    = trail
standing   = versus
strategy   = senator
sustain    = young
system     = commit
tendency   = probably
tough      = constitute
toward     = enough
weapon     = possible
